alumna – alumnae
alumnus – alumni
analysis – analyses
antithesis – antitheses
axis – axes
bacterium – bacteria
basis – bases
bison – bison
child – children
codex – codices
corpus – corpora
crisis – crises
criterion – criteria
curriculum – curricula
datum – data
deer – deer
diagnosis – diagnoses
die – dice
dwarf – dwarves
ellipsis – ellipses
erratum – errata
faux – pas
fish – fish
focus – foci
foot – feet
fungus – fungi
goose – geese
graffito – graffiti
half – halves
hoof – hooves
hypothesis – hypotheses
index – indices
larva – larvae
leaf – leaves
loaf – loaves
louse – lice
man – men
matrix – matrices
minutia – minutiae
moose – moose
mouse – mice
nebula – nebulae
nucleus – nuclei
oasis – oases
offspring – offspring
ovum – ova
ox – oxen
parenthesis – parentheses
phenomenon – phenomena
quiz – quizzes
salmon – salmon
scarf – scarves
self – selves
series – series
sheep – sheep
shrimp – shrimp
species – species
stimulus – stimuli
swine – swine
syllabus – syllabi
synopsis – synopses
thesis – theses
thief – thieves
tooth – teeth
trout – trout
vertebra – vertebrae
wife – wives
wolf – wolves
woman – women
